//MAP CONVERTED BY dmm2tgm.py THIS HEADER COMMENT PREVENTS RECONVERSION, DO NOT REMOVE
"a" = (
/obj/structure/barricade/bars,
/obj/structure/curtain{
	color = "#845f58"
	},
/turf/open/floor/plasteel/f13{
	icon_state = "plating"
	},
/area/shuttle/escape)
"c" = (
/obj/docking_port/mobile/emergency{
	dwidth = 24;
	height = 6;
	name = "Vault emergency shuttle";
	width = 25
	},
/turf/closed/indestructible/opshuttle,
/area/shuttle/escape)
"i" = (
/obj/structure/sign/poster/prewar/poster94{
	pixel_x = 32
	},
/obj/structure/chair/comfy/shuttle{
	dir = 8
	},
/turf/open/floor/plasteel/shuttle{
	color = "#89CFF0"
	},
/area/shuttle/escape)
"j" = (
/turf/open/floor/plasteel/shuttle{
	color = "#89CFF0"
	},
/area/shuttle/escape)
"k" = (
/obj/structure/shuttle/engine/propulsion,
/turf/open/floor/plasteel/f13{
	icon_state = "plating"
	},
/area/shuttle/escape)
"l" = (
/obj/structure/chair/comfy/shuttle{
	dir = 1
	},
/turf/open/floor/plasteel/shuttle{
	color = "#89CFF0"
	},
/area/shuttle/escape)
"m" = (
/obj/structure/sign/poster/prewar/poster72{
	pixel_x = 32
	},
/turf/open/floor/plasteel/shuttle{
	color = "#89CFF0"
	},
/area/shuttle/escape)
"n" = (
/obj/structure/closet/crate,
/turf/open/floor/plasteel/shuttle{
	color = "#89CFF0"
	},
/area/shuttle/escape)
"o" = (
/obj/machinery/computer/emergency_shuttle,
/turf/open/floor/plasteel/shuttle{
	color = "#89CFF0"
	},
/area/shuttle/escape)
"q" = (
/obj/machinery/door/airlock/shuttle,
/turf/open/floor/plasteel/shuttle{
	color = "#89CFF0"
	},
/area/shuttle/escape)
"r" = (
/obj/machinery/door/airlock/shuttle,
/turf/open/floor/plasteel/f13{
	icon_state = "plating"
	},
/area/shuttle/escape)
"t" = (
/obj/structure/cargocrate,
/turf/open/floor/plasteel/shuttle{
	color = "#89CFF0"
	},
/area/shuttle/escape)
"u" = (
/obj/structure/sign/poster/prewar/poster62{
	pixel_x = -32
	},
/obj/structure/chair/comfy/shuttle{
	dir = 4
	},
/turf/open/floor/plasteel/shuttle{
	color = "#89CFF0"
	},
/area/shuttle/escape)
"w" = (
/turf/closed/wall/rust,
/area/shuttle/escape)
"x" = (
/obj/structure/simple_door/metal/barred,
/obj/structure/curtain{
	color = "#845f58"
	},
/turf/open/floor/plasteel/f13{
	icon_state = "plating"
	},
/area/shuttle/escape)
"z" = (
/obj/structure/decoration/smokeold{
	pixel_x = 32
	},
/turf/open/floor/plasteel/shuttle{
	color = "#89CFF0"
	},
/area/shuttle/escape)
"B" = (
/obj/machinery/light/small{
	dir = 8;
	light_color = "#d8b1b1"
	},
/obj/structure/chair/comfy/shuttle{
	dir = 4
	},
/turf/open/floor/plasteel/shuttle{
	color = "#89CFF0"
	},
/area/shuttle/escape)
"G" = (
/obj/machinery/light/small{
	dir = 8
	},
/obj/structure/chair/comfy/shuttle{
	dir = 4
	},
/turf/open/floor/plasteel/shuttle{
	color = "#89CFF0"
	},
/area/shuttle/escape)
"H" = (
/obj/structure/closet/crate,
/obj/machinery/light/small{
	dir = 4
	},
/turf/open/floor/plasteel/shuttle{
	color = "#89CFF0"
	},
/area/shuttle/escape)
"K" = (
/obj/structure/table/plasmaglass,
/turf/open/floor/plasteel/shuttle{
	color = "#89CFF0"
	},
/area/shuttle/escape)
"N" = (
/obj/structure/sign/poster/prewar/poster81{
	pixel_x = -32
	},
/obj/structure/chair/comfy/shuttle{
	dir = 4
	},
/turf/open/floor/plasteel/shuttle{
	color = "#89CFF0"
	},
/area/shuttle/escape)
"P" = (
/obj/structure/chair/comfy/shuttle{
	dir = 8
	},
/turf/open/floor/plasteel/shuttle{
	color = "#89CFF0"
	},
/area/shuttle/escape)
"R" = (
/obj/machinery/light/small{
	dir = 4
	},
/obj/structure/chair/comfy/shuttle{
	dir = 8
	},
/turf/open/floor/plasteel/shuttle{
	color = "#89CFF0"
	},
/area/shuttle/escape)
"W" = (
/obj/structure/decoration/smokeold{
	pixel_x = 32
	},
/obj/structure/table,
/turf/open/floor/plasteel/shuttle{
	color = "#89CFF0"
	},
/area/shuttle/escape)
"X" = (
/obj/structure/shuttle/engine/heater,
/turf/open/floor/plasteel/f13{
	icon_state = "plating"
	},
/area/shuttle/escape)
"Y" = (
/obj/structure/chair/comfy/shuttle{
	dir = 4
	},
/turf/open/floor/plasteel/shuttle{
	color = "#89CFF0"
	},
/area/shuttle/escape)
"Z" = (
/turf/closed/indestructible/opshuttle,
/area/shuttle/escape)

(1,1,1) = {"
Z
Z
Z
Z
Z
Z
Z
Z
Z
r
Z
Z
Z
Z
Z
r
Z
Z
Z
Z
q
Z
Z
Z
c
"}
(2,1,1) = {"
Z
K
j
j
B
Y
a
G
Y
j
Y
G
a
G
u
j
N
G
Z
j
j
n
Z
X
k
"}
(3,1,1) = {"
Z
o
l
j
j
j
x
j
j
j
j
j
x
j
j
j
j
j
x
j
j
j
Z
X
k
"}
(4,1,1) = {"
Z
o
l
j
j
j
x
j
j
j
j
j
x
j
j
j
j
j
x
j
j
t
Z
X
k
"}
(5,1,1) = {"
Z
K
j
j
R
P
a
R
i
W
P
R
a
R
P
W
P
R
Z
H
m
z
Z
X
k
"}
(6,1,1) = {"
Z
Z
Z
Z
Z
Z
Z
Z
Z
Z
Z
Z
Z
Z
Z
Z
w
Z
Z
Z
Z
Z
Z
Z
Z
"}
